# vim: ft=sh nospell
* Bunad -> drakt
* Dugnad -> arbeid i nabolaget
* innpust
* fiskepinne
* en ørken -> område uten vegtasjon
* fallsjkerm
* strikkhopp
* et rullebrett -> et skateboard
* ei kule -> tredimensional sirkel
* en dråpe / et drypp -> vannkule
* ei tåke -> vanndrypp i luften men ikke regn, forårsaker dårlig sikt
* iallfall -> i hvert fall
* kle på meg
* å sy, syr, sydde, sydd -> nähen
* le, ler, lo, led
* la, lar, lot, latt
* ligge, ligger, lå, ligget
* ikke mer = ikke lenger
* forresten = en ting til
* tøysete = ha lyst å tøyse
* å tøyse = å tulle
* modig = mutig
* flau = skamfull
* skuffet = følelse når noe nås ikke forventningene
* opprømt = godt humør
* å grue seg for noe = å være redd for noe
* å gre = ordne hårene med en kam
* å dyrke, dyrker, dyrket, dyrket = å plante planter eller å ha dyr som produserer noe å spise eller bruke annerledes
* ei mark = område som bønder bruker for å dyrke
* å slå seg ned = å sitte
* å har rett i noe = å si noe som er riktig
* et lyn = elektrisk sjokk som kommer ned fra himmelen mens uvær
* fryktelig = forferdelig
* klok = lurt
* å få råd = ha nok penger for å kjøpe noe
* prosit = versigne deg
* å lengte etter noe = å savne noe
* å trille = å rulle
* ei tåre = vann som kommer fra øya
* å legge = to put
* å piske = slå noe (for eksempel i kjøkken: piske deig for vafler)
* en vikar = noen som gjør jebben i stede for den som egentlig skulle gjøre jobben
* skrevne og uskrevne regler
* ting og tang
* Jo da = Ja, doch
* kåpe, kåper, kåpa, kåpene = Mantel
* kvalm = føle seg syk, som man måtte kaste opp
* å trøste, trøster, trøstet, har trøstet
* blek = hvit i ansiktet
* å brekke, brekker, brakk, har brukket
* å være like i nærheten = å være ikke langt unna
* en ankel
* en albue
* et lår, låret, lår, lårene
* Er du dårlig?
* Verker det? = Gjør hele kroppen vond?
* Hva feiler det deg? = Hva er i veien?
* å verke = gjør vondt
* et bryst, brystet, bryst, brystene #Ikke bryster
* legget = Beina mellom kneet og foten
* en tommel(finger)
* en pekefinger
* en langefinger
* en ringfinger
* en lillefinger
* ei hånd
* ei tå, tåa, tær, tærne,
* en legg, legget, legger, leggene
* et kinn
* et venterom
* å være lei seg = være trist
* ei hake = Kinn
* en ånde = puste
* trett = trøtt
* et øyebryn
* et skjegg
* en bart
* å skli, klir, sklei/skled/sklidde, har sklidd
* å tråkke, tråkker, tråkket, har tråkket
* en sugetablett
* en malerkoste = Pinsel
* en koste = Besen
* å skynde, skynder, skyndet/skyndet, har skyndet/skyndt
* et loft = et rom i taket
* en kommode = et skap i soverommet
* ei vaskemaskin = maskin for å vaske klær
* en tørketrommel = maskin for å tørke klær
* en vask = som håndvask men
* ei skuffe = noe du kan trekke ut av et skap
* en komfyr = ei {koke,steke}plate + en ovnen
* en støvsuger
* ei pute = det du ligger på med hodet i senga
* et laken det du ligger på med kroppen i senga, ikke hodet
* ei dyne = det du dekker deg til med i senga
* et dynetrekk = det du putt
* et putetrekk = det du putter over puta
* et pledd = tynn dyne
* en kasserolle = ei gryte
* ei vifte = det som suger inn liften nå du steker
* ei flis = det du har på veggen i badet eller kjøkkenet
* et maleri
* slitt = preget av å blitt brukt lenge
* å få til = å klare noe
* en elev = noen som går på skole
* en vott = klær du kan har på hendene for ikke bli varm
* en gym (gymnastikk) = en skolefagg hvor man gjør idrett
* ei kroppsøving = gym
* fag: "K&H" = kunst og håndverk
* KRLE = kristendom, religion, livssyn og etikk
* å skuffe, skuffer, skuffet, skuffet = enttäuschen
* ei taushet: "tale er sølv, taushet er gull"
* en duk = et tøystykke som ligger på et bord for å beskytte det
* et smykke = en gjenstand som man kan ha på seg for å pynte seg, "Schmuck"
* svigerforeldrene
* å avspasere = ha fritid etter å ha arbeidet overtid
* å sovne = overgang fra våken til sovende tilstand
* a = a
* r = err
* e = är
* æ = a men munden litt mindre åpen
